Team,1ยบ,2ยบ,3ยบ,4ยบ,Tot
Brasile,5,2,2,1,10
Italia,4,2,1,1,8
Germania,3,4,4,1,12
Argentina,2,2,0,0,4
Uruguay,2,0,0,3,5
Francia,1,1,2,1,5
Spagna,1,0,0,1,2
Inghilterra,1,0,0,1,2
Olanda,0,3,0,1,4
Rep. Ceca,0,2,0,0,2
Ungheria,0,2,0,0,2
Svezia,0,1,2,1,4
Polonia,0,0,2,0,2
Austria,0,0,1,1,2
Portogallo,0,0,1,1,2
Stati Uniti,0,0,1,0,1
Cile,0,0,1,0,1
Croazia,0,0,1,0,1
Turchia,0,0,1,0,1
Serbia,0,0,0,2,2
Russia,0,0,0,1,1
Belgio,0,0,0,1,1
Bulgaria,0,0,0,1,1
Corea del Sud,0,0,0,1,1